0 3 0 1 1 1 1 0 1 3 0 0 0 0 1 0 0 1 0 1 0
0 0 0 0 0 0 0 d 0 0 0 0 0 0 0 0 0 0 0 0 0
0 0 0 0 0 0 0 0 0 0 1 0 0 0 1 0 0 1 1 0 1
0 0 0 0 0 1 0 0 0 0 0 1 0 0 0 1 0 0 0 0 0
0 0 0 0 0 1 1 0 0 0 3 0 0 0 1 0 0 0 0 0 1
1 0 0 0 0 0 0 0 0 1 0 0 4 0 0 0 1 0 0 0 0
0 1 0 0 1 0 0 0 1 1 0 0 d 1 0 0 0 1 0 0 0
0 0 0 0 0 1 0 0 0 0 0 0 0 0 0 0 1 * 0 0 0
0 d 0 0 1 0 1 0 0 0 0 1 0 0 1 1 0 0 0 0 0
0 1 0 0 0 0 b h 1 1 0 0 0 b 0 0 5 1 0 0 0
0 0 1 0 0 0 0 1 0 0 0 0 0 0 0 1 0 0 0 0 g
0 0 1 0 0 0 0 0 5 0 0 0 1 0 0 0 0 0 1 0 0
0 0 0 1 0 s 0 0 0 0 1 0 0 0 0 0 5 1 0 0 0
0 0 0 0 0 0 0 0 0 0 0 0 0 0 0 0 0 0 1 0 0
1 0 0 4 0 0 0 0 1 0 0 0 0 0 0 0 0 0 0 0 1
