0 0 1 0 0 0 5 0 0 0 0 1 0 0 0 0 s 1 0 0 0
0 0 0 1 0 0 0 1 0 0 0 0 0 0 0 1 1 1 0 1 0
b 4 1 0 1 0 0 0 0 0 g 0 1 0 0 0 0 0 0 0 1
0 0 d 0 0 1 0 0 0 1 0 0 0 0 0 1 0 0 0 0 0
0 1 1 0 0 1 0 0 0 1 0 0 0 0 1 0 0 0 0 1 0
* 1 1 0 1 0 0 0 0 1 1 1 1 1 0 b 0 0 1 0 1
1 0 1 b 1 0 0 0 0 b 0 0 1 0 0 1 0 0 1 1 0
0 0 1 0 0 0 0 3 0 0 0 0 3 0 1 0 b 1 0 0 0
0 0 0 0 0 1 0 0 0 0 1 0 0 0 0 0 0 0 1 0 0
1 0 1 0 0 1 0 0 0 0 0 0 0 0 0 1 0 0 1 0 1
0 1 0 0 h 0 1 0 1 0 0 0 1 1 0 0 0 0 d 0 1
0 0 0 0 0 1 0 0 0 0 5 0 3 0 0 0 0 1 0 0 0
0 0 0 0 0 0 1 0 0 0 0 0 1 0 0 0 0 4 0 0 0
1 0 0 g 0 1 0 1 0 0 0 0 0 0 0 0 0 1 0 1 0
1 1 1 0 0 0 0 0 0 0 0 0 0 0 0 1 0 0 0 0 0
