0 0 1 0 0 0 0 1 1 0 0 1 1 0 1 1 0 0 1 0 0
0 h 0 1 0 0 1 1 1 0 h 0 0 0 0 1 3 0 0 s 0
0 0 0 0 1 1 0 b 1 g 0 0 1 1 1 3 d 0 0 0 0
* 1 0 0 0 g 1 0 1 0 1 0 0 4 1 h 0 0 0 0 0
1 1 1 0 0 1 0 0 1 0 0 0 0 1 0 0 1 1 0 0 0
0 0 1 b 1 0 0 0 0 1 0 0 0 1 0 0 0 0 0 1 0
1 0 0 0 0 1 0 0 0 1 0 1 0 0 0 0 0 0 0 0 0
0 0 0 0 1 0 0 0 0 1 0 0 0 0 0 1 1 0 0 0 0
d 0 0 0 0 0 0 3 3 0 0 0 1 1 1 0 0 1 0 1 0
1 0 0 0 0 0 0 0 0 1 0 0 h 0 1 0 0 0 1 0 1
0 0 0 1 0 0 0 1 0 3 0 d 0 0 1 0 0 0 0 0 1
0 0 0 0 1 h 1 1 0 0 d 0 0 0 0 0 1 1 0 0 0
0 0 1 0 0 0 3 0 0 0 0 3 1 0 0 1 3 0 0 0 0
0 0 1 1 0 g 0 0 0 0 1 0 0 0 0 1 0 0 0 5 0
0 0 1 0 0 0 1 0 0 0 1 1 0 0 0 0 0 b 0 3 0
