0 0 0 0 0 0 0 0 0 0 0 b 0 0 0 0 0 1 0 1 0
1 0 0 0 0 0 0 0 0 0 0 0 g 0 d 1 0 0 0 1 1
0 b 0 0 0 3 0 0 b 0 1 0 0 0 0 0 0 0 0 0 0
0 0 0 0 0 0 0 0 0 0 0 0 0 0 0 3 1 1 0 0 0
0 1 b d 0 0 0 0 0 1 3 0 0 1 0 0 1 0 0 4 0
1 1 0 0 0 0 0 1 0 0 0 0 0 1 0 0 0 0 0 0 0
0 0 0 0 0 0 h 3 0 0 0 0 0 h 0 0 0 0 0 1 0
0 0 0 0 0 4 0 1 0 1 0 0 0 0 0 0 0 0 0 0 0
0 0 0 0 0 0 0 0 0 0 0 0 0 0 0 0 0 1 0 3 0
0 1 0 0 0 0 0 0 1 1 0 0 0 0 0 1 b 0 1 0 0
0 0 0 0 0 1 1 3 0 0 0 0 0 0 b 1 1 0 0 0 0
0 0 0 1 0 0 d 0 1 0 1 0 1 0 0 0 0 0 0 0 s
0 1 0 0 0 1 0 1 0 0 0 0 3 0 0 0 0 1 0 1 0
0 0 1 0 1 0 b 3 0 0 0 0 1 0 1 0 0 0 0 0 0
0 d 0 0 * 1 0 0 0 0 0 1 0 0 0 0 0 0 0 0 1
