1 1 0 0 1 1 1 1 1 1 1 1 1 1 1 1 1 1 1 1 1
1 0 b 0 b 0 0 0 0 0 0 1 0 b p 1 0 0 1 0 1
1 0 0 0 0 0 0 0 0 0 0 1 0 0 0 1 0 3 0 0 0
0 0 0 0 1 0 0 1 0 0 4 1 0 0 0 1 0 0 0 0 0
0 5 0 0 1 0 1 1 1 1 1 1 0 1 0 1 1 0 1 0 1
0 0 0 0 0 1 0 0 0 0 0 0 4 0 1 1 0 4 0 1 1
1 0 0 s 0 0 0 0 1 0 0 0 0 0 0 0 0 0 0 0 1
1 0 0 0 1 0 0 0 1 0 0 0 0 0 3 0 0 0 0 3 0
1 0 0 0 1 4 0 h 1 1 1 1 1 0 0 0 1 1 0 0 0
1 0 0 0 0 0 0 0 0 0 1 0 5 0 0 1 0 0 0 0 1
1 4 h 0 1 0 h 0 0 0 1 0 0 0 g 0 0 0 0 0 0
1 1 0 0 0 1 0 1 1 0 0 0 1 1 1 0 0 1 1 1 1
0 0 0 0 0 0 0 0 0 0 0 0 0 1 1 0 0 0 0 k 1
0 0 0 0 0 1 0 4 0 0 h 0 0 0 0 1 0 0 5 0 0
1 1 0 0 0 0 1 1 1 0 0 0 0 0 0 1 0 0 0 0 0
