0 0 0 b 1 0 0 1 0 0 1 0 0 d 0 0 0 0 1 0 0
0 1 0 0 0 0 0 1 0 0 0 0 0 0 1 0 0 0 0 0 0
0 1 1 0 0 0 0 1 1 0 0 0 1 0 0 1 1 0 0 0 g
1 0 0 0 0 1 0 0 0 0 1 0 0 0 0 0 0 1 0 0 0
3 1 0 1 0 0 0 0 0 3 1 0 0 0 h 0 0 0 1 1 0
1 0 0 0 1 0 4 0 0 0 0 1 0 0 0 0 1 0 0 0 0
0 1 0 1 0 0 0 0 0 0 1 0 0 0 0 0 0 4 0 1 0
0 0 0 h 0 0 0 0 1 0 0 0 0 1 0 0 0 0 0 0 1
0 0 0 0 1 g 0 0 0 0 h 1 0 0 0 0 0 0 0 g 0
0 0 0 0 0 0 0 0 0 0 0 0 0 0 0 1 0 0 0 0 d
0 0 0 1 1 d 0 0 0 0 1 1 0 1 b 0 1 0 0 1 1
0 s 0 1 0 1 3 0 0 1 0 1 0 1 0 0 0 0 1 * 0
0 0 0 0 0 1 1 1 0 1 1 0 0 0 3 0 d 0 0 0 0
1 0 0 0 3 0 0 0 1 1 0 0 0 1 1 1 1 0 0 1 0
1 0 1 1 0 0 0 0 0 0 0 1 0 0 0 0 0 0 0 0 1
