1 1 1 1 1 1 1 1 1 1 1 1 1 1 1 1 1 1 1 1 1
1 s 0 0 0 0 0 g 0 0 0 0 0 0 4 0 0 0 0 0 1
1 0 1 1 0 1 1 1 0 1 0 1 0 1 0 1 0 1 1 0 1
1 0 0 0 0 0 0 0 0 0 0 0 0 0 0 0 0 0 0 0 1
1 0 1 1 1 1 0 1 1 1 5 1 0 1 0 1 0 1 1 0 1
1 0 1 1 0 1 0 1 0 1 0 1 0 1 0 1 0 1 1 0 1
1 0 0 0 0 0 0 d 0 0 0 0 0 0 b 0 0 0 0 0 1
1 0 1 1 1 1 0 1 1 1 h 1 0 1 0 1 0 1 1 0 1
1 0 0 0 0 0 0 0 0 0 0 0 0 0 0 0 0 0 g 0 1
1 0 1 1 0 1 0 1 0 1 0 1 0 1 0 1 0 1 1 0 1
1 0 0 0 d 0 0 0 0 0 0 0 0 0 0 0 0 0 0 0 1
1 0 1 1 1 1 0 1 1 1 0 1 0 1 0 1 0 1 1 * 1
1 0 0 0 0 0 h 0 0 0 0 0 0 0 0 d 0 0 0 0 1
1 0 1 1 1 1 1 1 1 1 1 1 1 1 1 1 1 1 1 1 1
1 1 1 1 1 1 1 1 1 1 1 1 1 1 1 1 1 1 1 1 1
