1 1 0 0 1 1 1 1 1 1 1 1 1 1 1 1
1 0 b 0 b 0 0 0 0 0 0 1 7 b * 1
1 0 0 0 0 0 0 0 0 0 0 1 0 0 0 1
0 0 0 0 1 0 0 1 0 0 0 1 0 0 0 1
0 0 0 0 1 0 1 1 1 1 0 1 0 1 0 1
0 0 0 0 0 1 0 0 1 0 0 0 4 0 1 1
1 0 0 0 0 0 0 0 1 0 0 0 0 0 0 0
1 0 0 0 1 0 0 0 1 0 0 0 0 0 3 0
1 0 0 0 1 4 0 0 1 1 1 1 1 0 0 0
1 0 0 0 0 0 0 0 0 0 1 0 0 0 0 1
1 4 h 0 1 0 h 0 0 0 1 0 0 0 g 1
1 1 0 0 0 1 1 1 1 0 0 0 1 1 1 1