1 1 b 0 1 1 1 1 1 1 1 1 0 0 0 1
1 0 0 0 0 0 1 0 0 0 0 1 0 0 0 1
1 d 0 0 0 0 0 0 0 0 0 1 b 0 0 1
0 0 0 0 1 0 0 1 0 0 0 1 0 0 0 1
0 0 0 0 1 0 1 1 1 1 0 1 0 1 0 1
0 0 0 0 0 1 0 0 1 0 0 0 0 0 1 1
1 d 0 0 0 0 0 0 0 0 0 0 0 0 g 0
1 0 0 0 1 0 0 0 1 0 0 0 0 0 0 0
1 0 0 0 1 0 0 0 1 1 1 1 1 0 0 0
1 0 0 0 0 0 0 0 0 0 1 0 0 0 0 1
1 0 0 0 1 0 0 h 0 0 0 0 0 0 g 1
1 1 0 0 0 1 1 1 1 0 0 0 1 1 1 1