1 1 b 0 1 1 1 1 1 1 1 1 0 0 0 1
1 4 0 0 0 0 1 0 0 0 * 1 2 0 0 1
1 d 0 0 0 0 0 0 0 0 0 1 b 0 0 1
0 0 0 0 1 0 0 1 0 0 0 1 0 0 0 1
0 0 0 0 1 0 1 1 1 1 0 1 0 1 0 1
0 0 0 0 0 1 0 0 1 0 5 0 0 0 1 1
1 d 0 0 0 0 0 0 0 0 0 0 0 0 g 0
1 0 0 0 1 0 0 0 1 0 0 0 0 0 0 0
1 0 0 0 1 0 0 0 1 1 1 1 1 0 0 0
1 0 0 0 0 0 0 0 0 3 1 0 0 0 0 1
1 0 0 2 1 4 0 h 0 0 0 0 0 0 g 1
1 1 0 0 0 1 1 1 1 0 0 0 1 1 1 1